10
W W W W W W W W W W
W F F F W F F F E W
W F F F F F F F F W
W F F F F F F F F W
W W F F F G F F W W
W F F F F F F F F W
W F F F F F F F F W
W F F F F F F F F W
W P F F F W F F F W
W W W W W W W W W W