12
W W W W W W W W W W W W
W F F F F F E F F F F W
W F F F W W W W W F F W
W F F F F F W W F F F W
W F F F F F F F F F F W
W F F G F F F F F F F W
W F F F F F F F F F F W
W F F F W F F W W W F W
W F W W W W F F F F F W
W F F F F F F F F F F W
W F F F F P F F F F F W
W W W W W W W W W W W W